3333333333333333333
3p00000000000000003
3000000000000000003
3001111151111111003
3001441444144441003
3001441444544441003
3001445444144441003	fhhhhh
3001111511111511003	999999
3001444441444441003	
3001444445444441003
3001444441444441003
3001444441444441003
3001115111111111003
3000000000000000003
30000000000000000w3
3333333333333333333








0 grass
1 wall
2 window
3 wall1
4 floor
5 door
p player
